NO ./textures/wall.xpm
SO ./textures/wall_2.xpm
WE ./textures/wall_3.xpm
EA ./textures/wall_4.xpm
F 10,10,10
C 1,100,100



11111
11111111111
10001W11111
1111



