EA   ./path_to_EA

         F  255,200,0

    WE ./path_to_WE
   			SO ./path_to_SO
            NO ./path_to_NO
        
		
		C  100,160,0


111 111
10010001
100000001
100000001
111111111