EA   ./path_to_EA

         F  255,200,0

    WE ./path_to_WE
   			SO ./path_to_SO
            NO ./path_to_NO
        
		C  100,160,0


 1111
1110111
10000001         
100000001
10000W11
111111111