NO ./textures/wall.xpm
SO ./textures/wall_2.xpm
WE ./textures/wall_3.xpm
EA ./textures/wall_4.xpm

F 10,0,10
C 1,1,100

11111111111111111111
10000000001 10000N011
11111111111 11111111
           1
            1
             111111
            11111
             1111





