NO ./textures/wall.xpm
SO ./textures/wall_2.xpm
WE ./textures/wall_3.xpm
EA ./textures/wall_4.xpm
                         
                                      
F 10,10,10
C 1,100,100

11111111111111111111
1000000000000000000111111
10000000010000000001     1
10000001111000000001      11111111111111
1000001111000000001
10000001111000000001
10000011111111000001
10000011111111000001
1000001111111000001
10000000000000000001
100000000W0000000001
10000000000000000001
11111111111111111111








