NO ./textures/wall.xpm
SO ./textures/wall_2.xpm
WE ./textures/wall_3.xpm
EA ./textures/wall_4.xpm
                         
                                      
F 10,0,10
C 1,1,100

                                
111111111111111111         
1000000000000000001
1000000000100000001
100W0000000100000001
1000000000000000001
1000000000000000001
1000000000000000001111111111111111111111111111111111
10000000000000000011000000000000000001
10000000000000000011000000000000000001
111111111111111111111111111111111111111111111111



