NO ./textures/wall.xpm
SO ./textures/wall_2.xpm
WE ./textures/wall_3.xpm
EA ./textures/wall_4.xpm

F 10,0,10
C 1,1,100

11111111111111111111
100000000000000000N011
1000000000000000000011
11111111111011111111
           1
            1
             111111
            11111
             1111





