NO ./textures/wall.xpm
SO ./textures/wall_2.xpm
WE ./textures/wall_3.xpm
EA ./textures/wall_4.xpm

F 220,100,0
C 225,30,0

 1111
11101111
100000001
100000001    
10001W11111 
111111111    
